0x000A: 63
0x000B: 68
0x000C: 34
0x000D: 30
0x000E: 73

0x0010: 68
0x0011: 31
0x0012: 64

0x0013: 34

0x0014: 70
0x0015: 34
0x0016: 74
0x0017: 74
0x0018: 33
0x0019: 72
0x001A: 6e
